1 13 17
#################
#p f     *      #
#s  *  # * #   ##
#            *  #
# b  1  *      ##
#            1  #
# #     *    # ##
#    *     *  2 #
# # * *  *   # ##
#     4    3    #
# # * *     #  ##
#    *   * 2    #
#################