1 13 17
#################
#p# #*#*# # # #*#
#  *   * *** 1 *#
#x # # #b# # # *#
#* * 2**  *   **#
# # # # # #*# # #
#*   * 3***    *#
#  # # #*# # # *#
#*  *  ***   *1 #
# # # # # # # #*#
#*   ** *2*  * *#
#* # # # # #*#  #
#################