1 13 17
#################
#p# # # ##* # #*#
# *s   ***   1 *#
#  #*# ## # # * #
#* * 2*   *   **#
# # #f# # #*# # #
#*   * 3***    *#
# *# # #*# # # *#
#*  *  ***   *4 #
# # # # #b# # #*#
#*   ** *3*  * *#
#* # # # # #*# x#
#################