1 13 17
#################
#p# #*#*# # # #*#
#  *   * ***   *#
#* # # #*# # # *#
#* *  **  *   **#
# # # # # #*# # #
#*   *  ***    *#
#  # # #*# # # *#
#*  *  ***   *  #
# # # # # # # #*#
#*   ** * *  * *#
#* # # # # #*# x#
#################

- 3 medium 1 low 1 hight