1 13 17
#################
#               #
# # #  # # # # ##
#               #
# #            ##
#               #
# #        # # ##
#               #
# # # # # #  # ##
#               #
# # # # # # #  ##
#               #
#################