1 13 17
#################
#p *  *  * 1    #
# #*# #*# # # #x#
#* * 2*   **  * #
#*# # #*# # #*# #
#  f   **   3  *#
#*#*# #*#*# # # #
#     **   *    #
# # # # # #*# #*#
#  *   *    3   #
#*# #*# # #*# #*#
#  * * 2   **   #
#################
