1 13 17
#################
#p ** *  * 2    #
# #*# #*# # # #*#
#* *   3  **    #
#*# # #*# # #*# #
#  *   *    ** *#
#*#*# #*#*# # #f#
#  **   *  4    #
#b# # # # #*# #*#
#  *4 ** *      #
#*# #*# # #*# #*#
#x * *  *   5   #
#################