0 13 17
#################
#p * #*125*#  **#
#  * #*345*#  **#
#***   b*b      #
#      f*f      #
#*    #s*s#    *#
#*   **bfs**   *#
#*    #b*b#    *#
#      f*f      #
#      s*s   ***#
#**  #*125*# *  #
#**  #*345*# * q#
#################