0 13 17
#################
#p              #
#               #
#               #
#               #
#               #
#               #
#               #
#               #
#               #
#               #
#              q#
#################