13 17
#################
#p              #
#               #
#               #
#               #
#               #
#               #
#               #
#               #
#               #
#               #
#               #
#################