1 13 17
#################
#p *     *      #
#   *  # * #   ##
#            *  #
# #  1  *      ##
#            1  #
# #     *    # ##
#    *     *  2 #
# # * *  *   # ##
#     4    3    #
# # * *     #  ##
#    *   * 2    #
#################