1 13 17
#################
#p *     *      #
#   *  # * #   ##
#            *  #
# #     *      ##
#               #
# #     *    # ##
#    *     *    #
# # * *  *   # ##
#               #
# # * *     #  ##
#    *   *      #
#################